@@@@@@@@@@@@@@@@@@@@@@@@@@@@@@@@@@@@@
@       @ @ @           @   @     @ @
@ @@@@@@@ @ @@@ @ @@@ @@@ @@@@@@@ @ @
@       @       @ @     @     @ @   @
@@@@@ @@@@@ @@@ @ @ @ @@@ @@@@@ @ @@@
@   @ @ @ @   @ @ @ @   @ @   @ @   @
@ @@@ @ @ @ @@@ @@@@@ @@@ @ @@@ @@@ @
@       @     @   @   @     @ @ @   @
@@@ @@@@@@@@@ @@@@@@@ @@@ @@@ @ @ @ @
@             @       @ @   @     @ @
@ @ @@@@@ @ @@@ @ @ @@@ @ @@@ @@@ @ @
@ @ @     @ @ @ @ @     @   @ @ @ @ @
@ @ @ @@@@@@@ @ @@@@@@@@@ @@@ @ @@@ @
@ @ @ @     @   @     @     @   @   @
@@@ @@@ @ @@@@@ @@@@@ @@@ @@@ @@@@@ @
@     @ @ @     @ @     @ @   @ @ @ @
@ @ @ @ @ @@@ @@@ @@@ @@@ @ @ @ @ @ @
@ @ @ @ @                 @ @ @     @
@@@ @@@@@@@ @ @ @@@@@ @@@ @ @@@ @@@@@
@       @ @ @ @     @   @     @ @   @
@@@@@ @ @ @@@@@@@@@ @@@@@@@@@@@ @ @@@
@   @ @           @ @     @   @ @   @
@ @@@ @@@@@ @@@@@@@@@ @@@@@ @ @ @@@ @
@ @   @      @        @     @       @
@ @ @ @@@@@ @@@ @ @ @ @ @@@@@@@@@@@@@
@ @ @   @     @ @ @ @       @   @ @ @
@ @ @@@ @@@ @ @ @ @@@@@@@@@ @@@ @ @ @
@ @   @ @   @ @ @   @ @   @ @ @     @
@ @@@ @@@ @@@@@ @@@ @ @ @@@@@ @ @@@@@
@       @   @     @ @     @   @ @   @
@@@ @ @@@@@ @@@@@ @@@ @@@ @ @@@ @ @@@
@ @ @ @ @ @ @ @     @ @   @ @   @ @ @
@ @ @@@ @ @ @ @ @@@@@@@@@ @ @ @ @ @ @
@   @   @   @                 @     @
@ @ @ @ @@@ @@@ @@@@@@@ @@@ @@@ @@@ @
@F@ @ @       @   @       @   @ @  A@
@@@@@@@@@@@@@@@@@@@@@@@@@@@@@@@@@@@@@
