@@@@@@@@@@@@@@@@@@@@@@@@@@@@@@@
@FFFFF@FFFFFFFFFFFFFFFFF@FFFFF@
@F@@@F@F@@@F@@@@@@@F@@@F@FFFFF@
@F@FFF@F@FFFFFF@FFFFFF@F@FFFFF@
@FFF@@@F@F@@@@F@F@@@@FFF@@@FFF@
@@@F@F@F@F@FFFFFF@FF@F@FFF@F@@@
@FFF@F@@@F@F@@@ @@@F@F@@@F@FFF@
@F@@@FFFFFFF@     @FFFFFFF@@@F@
@FFF@F@@@@@F@@@@@@@F@F@@@F@FFF@
@@@F@FFF@F@FFFF@FFFF@F@FFF@F@@@
@FFF@@@F@F@@@@F@F@@@@F@F@@@FFF@
@FFFFFFF@FFFFFF@FFFFFF@FFFFF@F@
@FFFFF@F@@@F@@@@@@@F@@@F@F@@@F@
@FFFFF@FFFFFFFFAFFFF@FFF@FFFFF@
@@@@@@@@@@@@@@@@@@@@@@@@@@@@@@@
