@@@@@@@@@@@@@@@@@@@@@
@                   @
@                   @
@                   @
@                   @
@         A         @
@                   @
@                   @
@                   @
@F                  @
@@@@@@@@@@@@@@@@@@@@@