@@@@@@
@FFFF@
@ @@F@
@ @@F@
@FA F@
@F@@@@
@FFFF@
@@@@@@