@@@@@@@@@@@@@@@@@@@@@@@@@@@@@@@
@FFFFFFFFFFFF@@@@@FFFFFFFFFFFF@
@@@F@FFF@@@FFFFFFFFF@F@FFF@F@@@
@FFF@@@F@F@@@@F@F@@@@@@F@@@FFF@
@F@FFFFF@FFFFFF@FFFFFF@FFFFF@F@
@F@@@F@@@@@F@@@@@@@F@@@F@F@@@@@
@FFFFF@FFFFFFFFAFFFF@FFF@FFFFF@
@@@@@@@@@@@@@@@@@@@@@@@@@@@@@@@
