@@@@@@@@@@@@@@@@@@@@@@@@@@@@@@@@@@@@
@                                 A@
@ @@@@@@@@@@@@@@@@@@@@@@@ @@@@@@@@ @
@ @@   @   @      @@@@@@@   @@     @
@ @@ @ @ @ @ @@@@ @@@@@@@@@ @@ @@@@@
@ @@ @ @ @ @             @@ @@     @
@ @@ @ @ @ @ @ @@@@  @@@    @@@@@@ @
@ @  @ @ @   @    @@ @@@@@@@@      @
@ @@ @ @ @@@@@@@@ @@        @@ @@@@@
@ @@ @   @@       @@@@@@@@@ @@     @
@    @@@@@@ @@@@@@@      @@ @@@@@@ @
@@@@@@      @       @@@@ @@ @      @
@      @@@@@@ @@@@@ @    @@ @@ @@@@@
@ @@@@@@      @       @@@@@ @@     @
@        @@@@@@ @@@@@@@@@@@ @@  @@ @
@@@@@@@@@@                  @@@@@@ @
@F         @@@@@@@@@@@@@@@@        @
@@@@@@@@@@@@@@@@@@@@@@@@@@@@@@@@@@@@
