@@@@@@@@@@@@@@@@@@@@@@@@@@@@@@
@F      @ @ @              @F@
@       @ @ @@@@@@ @@@@@@@ @ @
@       @        @     @ @   @
@@@@@ @@@@@ @@@ @@ @@@@@ @ @@@
@   @ @ @ @   @    @     @   @
@ @@@ @ @ @ @@@@@@@@ @@@ @@@ @
@       @     @@     @ @ @   @
@@@ @ @@@@@@@ @@@@ @@@ @ @ @ @
@ @           @@     @     @ @
@ @ @@@@@ @ @@@@ @ @@@ @@@ @ @
@   @     @      @ @   @ @@@ @
@F  @A@@@@@      @ @@@ @    F@
@@@@@@@@@@@@@@@@@@@@@@@@@@@@@@