@@@@@@@@@@@@@@@@@@@@
@FFF@FFFFFFFFF@@FFF@
@F@F@F@@@@@@@@@@F@F@
@FFFFFFFFFFFFFFFFFF@
@@@@@@@@F@F@@@@@@@A@
@@@@@@@@FFFFFFF    @
@@@@@@@@@@@@@@@@@@@@
