@@@@@@@@@@@@@@@@@@@@
@FFFFFFFFFFFFFFFFFF@
@FFFFFFFFFFFFFFFFFF@
@FFFFFFFFAFFFFFFFFF@
@FFFFFFFFFFFFFFFFFF@
@FFFFFFFFFFFFFFFFFF@
@@@@@@@@@@@@@@@@@@@@
