@@@@@@@@@@@@@@@@@@@@@@@@@@@@@@@@@@@@@
@                                  A@
@            @                      @
@            @                      @
@            @                      @
@            @                      @
@            @                      @
@            @      @               @
@            @      @               @
@            @      @               @
@            @      @               @
@            @      @               @
@            @      @               @
@            @      @               @
@@@@@@@@@@@@@@      @@@@@@@@@@@@@@@@@
@            @                      @
@            @                      @
@            @                      @
@                                   @
@                                   @
@                                   @
@F                                  @
@@@@@@@@@@@@@@@@@@@@@@@@@@@@@@@@@@@@@