@@@@@@@@@@@@@@@@@@@@
@F           FFFA F@
@F@@F@@F@@F@@F@@ @F@
@ @@ @FFFFF      @F@
@@@@@@@@@@@@@@@@@@@@
