@@@@@@@@@@@@@@@@@@@@@@
@ @@        @ @      @
@    @@@@@@ @ @@@@@@ @
@@@@@@     A  @      @
@    @ @@@@@@ @@ @@@@@
@ @@@@ @         @   @
@        @@@ @@@   @ @
@@@@@@@@@@    @@@@@@ @
@F         @@        @
@@@@@@@@@@@@@@@@@@@@@@