@@@@@
@FA @
@@@ @
@F  @
@@@@@
