@@@@@@@@@
@FF   FF@
@@@@F@@ @
@   A   @
@F@@ @@F@
@F@F   F@
@@@@@@@@@
