@@@@@@@
@    A@
@ @@@ @
@  @  @
@@   @@
@F @@@@
@@@@@@@
