@@@@@@@@@@@@@@@@@@@@
@F           FF@   @
@F@@F@@F@@F@@F@@ @ @
@        A       @ @
@@@@@@@@@@@@@@@@@@ @
@FFFFF             @
@@@@@@@@@@@@@@@@@@@@
